----------------
----------------
---xx------xx---
---xx------xx---
----------------
----------------
-------xx-------
-------xx-------
----------------
----------------
----xxxxxxxx----
---xx------xx---
---x--------x---
----------------
----------------
----------------