xxxxxxxxxxxxxxxx
x--------------x
x--------------x
x--------------x
x---xxx--xxx---x
x---x------x---x
x---x------x---x
x---x------x---x
x---x------x---x
x---x------x---x
x---x------x---x
x---xxxxxxxx---x
x--------------x
x--------------x
x--------------x
xxxxxxxxxxxxxxxx