xxxxxxxxxxxxxxxx
x--------------x
x--------------x
x--------------x
x--xxx--x--xx--x
x--x----x---x--x
x--x----x---x--x
x--x----x---x--x
x--x----x---x--x
x--x----x---x--x
x--x----x---x--x
x--xxxxxxxxxx--x
x--------------x
x--------------x
x--------------x
xxxxxxxxxxxxxxxx